NO assets/CRATE_1B.xpm

SO assets/STEEL_1A.xpm

WE assets/LIGHT_1B.xpm

EA assets/SUPPORT_1B.xpm

F 165,42,42

C 0,0,255


111111111111111111111111111111
111111111000100000000000011111111111
100000000000000000111000100001
110000100000000000000000001111111111
100001111111000000010000111111         1
1111111000000000W0000000000001 111111110111111111111111111
111100000000001100000001000011         1
100000000000000000000000000001
110000000000011110000000000011
100000000000111000000000000011
11000000000011100000000000111
110000000001111000000000000111
111111111111111111111111111111111 