NO./path_to_the_north_texture

SO./path_to_the_south_texture

WE./path_to_the_west_texture

EA./path_to_the_east_texture

F 220,100,0
C 225,30,0

       1111111111111111111111111        1111111111111111111111111         
        1000000000110000000000001        1*0000000110000010000001 
        1H11000001110000000000001        100000N001110000010000001 
        1001000000000000000000001        1000000000000000000000001
111111111011000001010000010000001111111111011000111H10000010000001
1000000000110000011111011111111111  100000000011000001111111111111111
1111011111111111110000001000111110111101011H110000000100011
1111011111111101110101000000111110111111111011001010000001
11000000110101011110000010000H0000000110101011110000010001
100000001000000011000001000111100000001000000010000001000111
1000000000000000110101001000110000000000000001101010010001
110000011101010111111111100111000001110101011111011110011
11111111 101000000000001111111111111 1011111000000011H11
1111111111H11111111111H11           11H1111111111111101111111  
1000000000000000000000001          1000000000110000010000001    
1011000001110000000000001         1011000001110000010000001   
10010000000000000000000011111111   1001000000H0000000000001111111
111111111H11000001010000000000001111111111011100001010000010000001
100000000011000001111101111111111100000000011000001111101111111111
11110111111111111100000010001111100111111111011100000010001
1111011111111101110101000000111110111111111011101010000001
1100000011010101111000001000111000000110101011110000010001
10000000100000001100001000000H00000001000000011000001000111
1000000000000000110101001000110000000000000001101010010001
110000011101010111110111100111000001110101011111011110011
11111111 101111111111111111111111111 1011111111111111111
          1                           1