NO ./path_to_the_north_texture

SO ./path_to_the_south_texture

WE ./path_to_the_west_texture

EA ./path_to_the_east_texture

F 220,100,0

C 225,30,0

        111111111111111111111111111111111111111111111111111
        1000000000110000000000001 
        1011000001110000000000001 
        1001000000000000000000001 
1111111110110000011100000000000W1 
100000000011000001110111111111111 
11110111111111011100000010011111111111111111111111111111111111111
11110111111111011101010010011
11000000110101011100000010011111111111111111
100000000000000011000000100110000000000001
1000000000000000110101001001111111111111111
1100000111010101111101111011111
11110111 11101011 11111010011
11111111 11111111 1111111111