NO assets/CRATE_1B.xpm

SO assets/STEEL_1A.xpm

WE assets/LIGHT_1B.xpm

EA assets/SUPPORT_1B.xpm

F 165,42,42

C 0,0,255

111111
11S011
100001
110011
111111

