NO ./path_to_the_north_texture

SO ./path_to_the_south_texture

WE ./path_to_the_west_texture

EA ./path_to_the_east_texture

F 165,42,42

C 0,0,255

1111111111
1000000001
1000001111
1000000001
100E000001
1111111111